33333333333333333333
33333333333333333333
33010000000100000033
33000010000000010033
33000000100000000033
33000000000000000033
00000000000000000000
00000000000000000000
00000000000000000000
33000000000000000033
33000200000000000033
33000000000010000033
33000000000000000033
33000022000000000033
33000200000000000033
33333333333333333333
33333333333333333333
33333333333333333333
33333333333333333333
33333333333333333333