33333333333333333333
33311111111111111333
33311111111111111333
33301111000010111333
33300000000001001333
33300000000000000333
33300000000000000000
33300000000000000000
33300000000000000000
33300000000000000333
33300000000000000333
33300000000000000333
33300000000000000333
33300000000000000333
33300000000000000333
33300000000000000333
33300000000000000333
33300000000000900333
33300000000000000333
33333333333333333333