33333333333333333333
33300000000000000333
33300000000000000333
33300000000000000333
33300000000000000333
33300000000000000333
33300000000000000000
33300000000000000000
33300000000000000000
33300000000000000333
33300000000000000333
33300000000000000333
33300000000000000333
33300000000000000333
33300000000000000333
33300000000000000333
33300000000000000333
33300000000000000333
33300000000000000333
33333333333333333333