33333333333333333333
33333333333333333333
33011000000110000033
33111110000011110033
33011000100001100033
33000000000000000033
00000001100000000000
00000001000000000000
00000000000000000000
33002200000000000033
33002200000001000033
33002200000110000033
33000000000010000033
33000000000000000033
33000222000000000033
33333333333333333333
33333333333333333333
33333333333333333333
33333333333333333333
33333333333333333333