33333333333333333333
33333333333333333333
33333333333333333333
33333333333333333333
33333333333333333333
33333333333333333333
00000000003333333333
00000000003333333333
00000000003333333333
33333000000700000600
33333004000700000600
33333000000700000600
33333000003333333333
33333000003333333333
33333000003333333333
33333000003333333333
33333000003333333333
33333000003333333333
33333000003333333333
33333000003333333333