33333333333333333333
33333000000000033333
33330000000000003333
33330000000000003333
33330000000000003333
33330000000000003333
33333333000033333333
33333333000033333333
33333333000033333333
00000000000000000333
00000000000000000333
00000000000000000333
33000033333333333333
33000033333333333333
33000033333333333333
33000033333333333333
33000000000000000000
33000000000000000000
33333333333333333333
33333333333333333333