33333333333333333333
33333333333333333333
33333333330000333333
33333333000000003333
33333300000000000033
33333300000000000033
33333300000000000033
33333300000000000033
33333300000000000033
33333300000000000033
33333300000000000033
33333300000000000033
33333300000000000033
33333300000000000033
33333300000000000033
33333300000000000033
00000700000000000033
00000700000000000033
33333330000000000033
33333333333333333333